10 10 20 10
0 0 0 G -1 -1 0 0 0 0
0 -1 -1 -1 -1 -1 -1 -1 -1 0
0 0 0 G1 -1 -1 0 0 0 0
1 4 -1 -1 -1 -1 -1 -1 0 0
0 0 -1 0 0 0 S1 -1 0 0
0 0 0 0 -1 -1 0 0 0 0
F1 0 -1 0 0 0 S -1 0 0
0 -1 -1 -1 -1 -1 -1 -1 -1 0
0 0 0 -1 0 0 -1 0 0 0
-1 0 0 0 0 0 0 0 0 -1