20 20 300 100
S 0 0 0 0 0 0 0 0 S1 0 0 0 0 0 0 9 0 0 0
0 -1 -1 -1 0 -1 0 -1 -1 0 -1 -1 -1 -1 0 -1 -1 -1 -1 0
0 -1 0 F1 0 0 0 8 -1 0 0 0 0 -1 0 -1 0 0 0 -1
0 0 0 -1 -1 -1 -1 0 -1 0 -1 -1 -1 -1 0 -1 -1 -1 -1 0
-1 -1 -1 -1 0 G1 0 9 -1 0 0 0 -1 0 0 0 S6 0 0 0
0 0 0 -1 0 -1 -1 0 -1 0 -1 -1 -1 -1 0 -1 -1 -1 -1 -1
0 -1 4 0 0 -1 0 0 -1 0 0 0 0 -1 0 0 7 0 0 -1
S5 -1 -1 -1 0 -1 0 -1 -1 0 0 -1 0 -1 0 -1 -1 -1 -1 0
0 0 0 7 0 0 0 -1 0 0 0 0 0 F2 0 0 0 0 0 0
0 F3 -1 -1 0 0 0 0 6 0 -1 -1 -1 -1 0 -1 -1 -1 -1 S2
0 -1 -1 -1 0 -1 -1 -1 -1 0 0 0 0 0 0 0 0 0 0 -1
0 -1 0 0 0 0 -1 0 0 S4 -1 -1 -1 -1 0 0 0 0 0 -1
-1 -1 0 -1 -1 -1 -1 -1 -1 0 0 0 2 0 0 -1 -1 -1 -1 -1
0 -1 0 -1 0 0 0 0 -1 0 -1 -1 -1 -1 0 G 0 0 0 -1
0 -1 0 -1 0 -1 -1 0 -1 0 0 0 0 0 0 -1 -1 -1 -1 0
0 0 G2 -1 0 0 0 0 0 0 0 0 -1 0 0 0 0 0 0 S3
3 -1 -1 0 0 -1 0 -1 -1 -1 -1 -1 -1 -1 -1 -1 -1 -1 -1 0
0 0 0 0 -1 0 0 0 -1 0 0 0 0 0 0 F4 0 0 0 0
0 0 0 0 0 0 0 0 0 0 0 0 0 0 0 0 0 0 0 0
0 0 0 0 0 0 0 0 0 0 0 0 0 0 0 0 0 0 0 0